full_name;age;position;Current Club;minutes_played_overall;minutes_played_home;minutes_played_away;nationality;appearances_overall;appearances_home;appearances_away;goals_overall;goals_home;goals_away;assists_overall;assists_home;assists_away;penalty_goals;penalty_misses;clean_sheets_overall;clean_sheets_home;clean_sheets_away;conceded_overall;conceded_home;conceded_away;yellow_cards_overall;red_cards_overall
Aaron Cresswell;32;Defender;West Ham United;1589;888;701;England;20;11;9;0;0;0;1;1;0;0;0;3;2;1;22;12;10;1;0
Aaron Lennon;35;Midfielder;Burnley;1217;487;730;England;16;7;9;1;1;0;1;1;0;0;0;4;2;2;20;8;12;1;0
Aaron Mooy;32;Midfielder;Huddersfield Town;2327;1190;1137;Australia;29;15;14;3;1;2;1;0;1;1;0;4;3;1;46;20;26;4;0
Aaron Ramsey;31;Midfielder;Arsenal;1327;689;638;Wales;28;14;14;4;2;2;6;5;1;0;0;7;6;1;12;2;10;0;0
Aaron Rowe;22;Forward;Huddersfield Town;69;14;55;England;2;1;1;0;0;0;0;0;0;0;0;0;0;0;1;0;1;0;0
Aaron Wan-Bissaka;24;Midfielder;Crystal Palace;3135;1605;1530;England;35;18;17;0;0;0;3;1;2;0;0;12;7;5;41;17;24;5;1
Abdelhamid Sabiri;25;Midfielder;Huddersfield Town;49;0;49;Morocco;2;0;2;0;0;0;0;0;0;0;0;0;0;0;3;0;3;0;0
Abdoulaye Doucouré;29;Midfielder;Watford;3062;1566;1496;France;35;18;17;5;3;2;6;2;4;0;0;5;3;2;54;27;27;7;0
Aboubakar Kamara;27;Forward;Fulham;687;468;219;France;13;8;5;3;1;2;0;0;0;1;1;2;1;1;16;9;7;2;0
Adalberto Peñaranda Maestre;25;Forward;Watford;0;0;0;Venezuela;0;0;0;0;0;0;0;0;0;0;0;0;0;0;0;0;0;0;0
Adam Lallana;34;Midfielder;Liverpool;465;189;276;England;13;6;7;0;0;0;0;0;0;0;0;6;1;5;2;1;1;1;0
Adam Masina;28;Defender;Watford;1003;463;540;Italy;14;7;7;0;0;0;1;1;0;0;0;2;1;1;19;8;11;5;0
Adam Smith;31;Defender;AFC Bournemouth;2073;1051;1022;England;25;12;13;1;1;0;1;0;1;0;0;9;5;4;30;10;20;6;1
Adama Diakhaby;26;Forward;Huddersfield Town;551;345;206;France;12;8;4;0;0;0;0;0;0;0;0;1;1;0;16;7;9;1;0
Adama Traoré;26;Midfielder;Wolverhampton Wanderers;890;315;575;Spain;29;12;17;1;0;1;1;1;0;0;0;6;4;2;11;2;9;1;0
Ademola Lookman;25;Forward;Everton;601;334;267;England;21;11;10;0;0;0;2;2;0;0;0;8;5;3;7;2;5;0;0
Adrián;35;Goalkeeper;West Ham United;0;0;0;Spain;0;0;0;0;0;0;0;0;0;0;0;0;0;0;0;0;0;0;0
Adrian Mariappa;36;Defender;Watford;1921;841;1080;Jamaica;26;12;14;0;0;0;0;0;0;0;0;6;3;3;29;10;19;3;0
Adrien Sebastian Perruchet Silva;33;Midfielder;Leicester City;88;8;80;Portugal;2;1;1;0;0;0;0;0;0;0;0;1;1;0;1;0;1;0;0
Ainsley Maitland-Niles;25;Midfielder;Arsenal;985;462;523;England;16;7;9;1;0;1;1;0;1;0;0;4;3;1;16;5;11;3;1
Alberto Moreno;30;Defender;Liverpool;155;90;65;Spain;2;1;1;0;0;0;0;0;0;0;0;0;0;0;2;1;1;0;0
Aleksandar Mitrović;28;Forward;Fulham;3282;1616;1666;Serbia;37;18;19;11;8;3;3;2;1;1;0;5;3;2;74;31;43;7;0
Alex Iwobi;26;Forward;Arsenal;1972;742;1230;Nigeria;35;18;17;3;1;2;6;3;3;0;0;8;7;1;31;8;23;0;0
Alex McCarthy;32;Goalkeeper;Southampton;2250;1170;1080;England;25;13;12;0;0;0;0;0;0;0;0;4;2;2;37;16;21;1;0
Alex Oxlade-Chamberlain;29;Midfielder;Liverpool;19;19;0;England;2;2;0;0;0;0;0;0;0;0;0;2;2;0;0;0;0;0;0
Alex Pritchard;29;Midfielder;Huddersfield Town;2092;992;1100;England;30;14;16;2;1;1;0;0;0;0;0;4;2;2;39;16;23;2;0
Alex Smithies;32;Goalkeeper;Cardiff City;0;0;0;England;0;0;0;0;0;0;0;0;0;0;0;0;0;0;0;0;0;0;0
Alexander Sørloth;26;Forward;Crystal Palace;173;121;52;Norway;12;8;4;0;0;0;0;0;0;0;0;4;3;1;1;0;1;0;0
Alexandre Lacazette;31;Forward;Arsenal;2503;1403;1100;France;35;19;16;13;9;4;8;4;4;0;0;7;7;0;28;10;18;2;0
Alexandre Nascimento Costa Silva;25;Forward;West Ham United;17;0;17;Portugal;1;0;1;0;0;0;0;0;0;0;0;0;0;0;0;0;0;0;0
Alexis Sanchez;33;Forward;Manchester United;877;387;490;Chile;20;10;10;1;1;0;3;0;3;0;0;6;2;4;8;4;4;3;0
Alfie Jones;25;Defender;Southampton;0;0;0;England;0;0;0;0;0;0;0;0;0;0;0;0;0;0;0;0;0;0;0
Alfie Mawson;28;Defender;Fulham;1131;547;584;England;15;8;7;0;0;0;0;0;0;0;0;3;2;1;25;10;15;2;0
Alfie Whiteman;24;Goalkeeper;Tottenham Hotspur;0;0;0;England;0;0;0;0;0;0;0;0;0;0;0;0;0;0;0;0;0;0;0
Ali Koiki;22;Defender;Burnley;0;0;0;England;0;0;0;0;0;0;0;0;0;0;0;0;0;0;0;0;0;0;0
Alireza Jahanbakhsh;29;Forward;Brighton & Hove Albion;1022;494;528;Iran;19;9;10;0;0;0;0;0;0;0;0;4;3;1;16;8;8;2;0
Alisson Becker;30;Goalkeeper;Liverpool;3420;1710;1710;Brazil;38;19;19;0;0;0;0;0;0;0;0;21;12;9;19;8;11;1;0
Alvaro Morata;30;Forward;Chelsea;943;530;413;Spain;16;8;8;5;3;2;0;0;0;0;0;9;4;5;11;6;5;3;0
Ander Herrera;33;Midfielder;Manchester United;1404;617;787;Spain;22;10;12;2;0;2;3;3;0;0;0;6;1;5;17;9;8;4;0
André Gomes;29;Midfielder;Everton;1986;972;1014;Portugal;27;13;14;1;1;0;1;1;0;0;0;10;6;4;27;13;14;7;0
Andre Gray;31;Forward;Watford;1358;809;549;England;29;15;14;7;5;2;2;2;0;0;0;5;3;2;23;16;7;2;0
André Schürrle;31;Midfielder;Fulham;1650;829;821;Germany;24;12;12;6;3;3;0;0;0;0;0;1;0;1;42;20;22;2;0
André-Frank Zambo Anguissa;26;Midfielder;Fulham;1518;587;931;Cameroon;22;10;12;0;0;0;0;0;0;0;0;3;2;1;30;10;20;3;1
Andreas Christensen;26;Defender;Chelsea;615;360;255;Denmark;8;4;4;0;0;0;0;0;0;0;0;3;3;0;7;2;5;1;0
Andreas Pereira;26;Midfielder;Manchester United;595;521;74;Brazil;15;10;5;1;1;0;1;1;0;0;0;1;1;0;10;7;3;5;0
Andrew Robertson;28;Defender;Liverpool;3219;1599;1620;Scotland;36;18;18;0;0;0;11;9;2;0;0;21;12;9;17;7;10;4;0
Andrew Surman;36;Midfielder;AFC Bournemouth;1438;526;912;England;18;7;11;0;0;0;0;0;0;0;0;5;3;2;35;7;28;2;0
Andriy Yarmolenko;33;Forward;West Ham United;459;269;190;Ukraine;9;5;4;2;0;2;0;0;0;0;0;1;1;0;4;1;3;2;0
Andros Townsend;31;Midfielder;Crystal Palace;3018;1571;1447;England;38;19;19;6;2;4;4;2;2;0;0;12;7;5;44;20;24;1;0
Andy Carroll;33;Forward;West Ham United;454;180;274;England;12;6;6;0;0;0;0;0;0;0;0;2;1;1;6;2;4;2;0
Angel Gomes;22;Midfielder;Manchester United;25;25;0;England;2;2;0;0;0;0;0;0;0;0;0;0;0;0;1;1;0;0;0
Angelo Ogbonna;34;Defender;West Ham United;1870;956;914;Italy;24;12;12;1;1;0;1;1;0;0;0;3;2;1;32;13;19;2;0
Angus Gunn;26;Goalkeeper;Southampton;1080;540;540;England;12;6;6;0;0;0;0;0;0;0;0;3;1;2;17;9;8;0;0
Anthony Driscoll-Glennon;22;Defender;Burnley;0;0;0;England;0;0;0;0;0;0;0;0;0;0;0;0;0;0;0;0;0;0;0
Anthony Knockaert;30;Midfielder;Brighton & Hove Albion;1832;982;850;France;30;16;14;2;1;1;6;5;1;0;0;3;3;0;36;17;19;5;1
Anthony Martial;26;Forward;Manchester United;1623;743;880;France;27;11;16;10;4;6;2;1;1;1;0;5;1;4;25;8;17;2;0
Antonio Barreca;27;Defender;Newcastle United;4;0;4;Italy;1;0;1;0;0;0;0;0;0;0;0;0;0;0;0;0;0;0;0
Antonio Rüdiger;29;Defender;Chelsea;2874;1350;1524;Germany;33;15;18;1;1;0;0;0;0;0;0;12;7;5;34;10;24;7;0
Antonio Valencia;37;Defender;Manchester United;466;196;270;Ecuador;6;3;3;0;0;0;0;0;0;0;0;2;0;2;5;4;1;2;0
Arijanet Muric;23;Goalkeeper;Manchester City;0;0;0;Montenegro;0;0;0;0;0;0;0;0;0;0;0;0;0;0;0;0;0;0;0
Aron Einar Gunnarsson;33;Midfielder;Cardiff City;2274;1240;1034;Iceland;28;14;14;1;1;0;1;1;0;0;0;8;4;4;37;20;17;5;0
Arthur Masuaku;28;Defender;West Ham United;1756;822;934;France;23;11;12;0;0;0;1;1;0;0;0;6;3;3;26;11;15;2;0
Artur Boruc;42;Goalkeeper;AFC Bournemouth;1080;540;540;Poland;12;6;6;0;0;0;0;0;0;0;0;4;2;2;17;4;13;2;0
Ashley Barnes;32;Forward;Burnley;2400;1307;1093;England;37;19;18;12;6;6;2;1;1;2;0;8;5;3;34;16;18;8;0
Ashley Westwood;32;Midfielder;Burnley;2822;1530;1292;England;34;18;16;2;0;2;7;2;5;0;0;7;5;2;44;22;22;5;0
Ashley Young;37;Midfielder;Manchester United;2568;1207;1361;England;30;14;16;2;1;1;2;2;0;0;0;4;2;2;41;16;25;10;1
Asmir Begović;35;Goalkeeper;AFC Bournemouth;2160;1080;1080;Bosnia and Herzegovina;24;12;12;0;0;0;0;0;0;0;0;5;3;2;44;19;25;0;0
Aymeric Laporte;28;Defender;Manchester City;3057;1526;1531;France;35;17;18;3;0;3;3;3;0;0;0;18;8;10;21;11;10;3;0
Ayoze Perez;29;Forward;Newcastle United;2929;1526;1403;Spain;37;19;18;12;9;3;2;1;1;0;0;11;5;6;34;21;13;2;0
Bakary Sako;34;Midfielder;Crystal Palace;25;8;17;Mali;4;3;1;0;0;0;0;0;0;0;0;1;1;0;0;0;0;0;0
Ben Chilwell;25;Defender;Leicester City;3240;1620;1620;England;36;18;18;0;0;0;4;1;3;0;0;10;6;4;39;15;24;4;0
Ben Davies;29;Defender;Tottenham Hotspur;1839;916;923;Wales;27;13;14;0;0;0;0;0;0;0;0;10;6;4;24;10;14;2;0
Ben Foster;39;Goalkeeper;Watford;3420;1710;1710;England;38;19;19;0;0;0;0;0;0;0;0;7;4;3;57;28;29;1;0
Ben Gibson;29;Defender;Burnley;63;63;0;England;1;1;0;1;1;0;0;0;0;0;0;0;0;0;3;3;0;1;0
Ben Hamer;34;Goalkeeper;Huddersfield Town;553;283;270;England;7;4;3;0;0;0;0;0;0;0;0;1;1;0;20;9;11;0;0
Ben Johnson;22;Forward;West Ham United;63;0;63;England;1;0;1;0;0;0;0;0;0;0;0;0;0;0;1;0;1;0;0
Ben Mee;33;Defender;Burnley;3420;1710;1710;England;38;19;19;0;0;0;2;1;1;0;0;8;5;3;57;27;30;9;0
Ben White;25;Defender;Brighton & Hove Albion;0;0;0;England;0;0;0;0;0;0;0;0;0;0;0;0;0;0;0;0;0;0;0
Ben Wilmot;23;Defender;Watford;26;0;26;England;2;0;2;0;0;0;0;0;0;0;0;1;0;1;2;0;2;0;0
Benjamin Mendy;28;Defender;Manchester City;900;450;450;France;10;5;5;0;0;0;5;3;2;0;0;4;1;3;6;4;2;1;0
Beram Kayal;34;Midfielder;Brighton & Hove Albion;934;494;440;Israel;18;9;9;1;0;1;1;1;0;0;0;5;3;2;15;8;7;4;0
Bernard Anício Caldeira Duarte;30;Midfielder;Everton;2128;960;1168;Brazil;34;16;18;1;0;1;3;1;2;0;0;14;9;5;19;5;14;5;0
Bernardo;27;Defender;Brighton & Hove Albion;1750;990;760;Brazil;22;11;11;0;0;0;1;1;0;0;0;4;2;2;28;17;11;4;0
Bernardo Silva;28;Midfielder;Manchester City;2853;1470;1383;Portugal;36;18;18;7;2;5;7;4;3;0;0;18;8;10;22;11;11;3;0
Bernd Leno;30;Goalkeeper;Arsenal;2835;1395;1440;Germany;32;16;16;0;0;0;0;0;0;0;0;7;6;1;39;12;27;0;0
Bobby Reid;29;Midfielder;Cardiff City;1422;725;697;England;27;11;16;5;4;1;2;1;1;1;0;6;2;4;27;19;8;0;0
Brian Murphy;39;Goalkeeper;Cardiff City;0;0;0;Republic of Ireland;0;0;0;0;0;0;0;0;0;0;0;0;0;0;0;0;0;0;0
Bright Enobakhare;24;Forward;Wolverhampton Wanderers;0;0;0;England;0;0;0;0;0;0;0;0;0;0;0;0;0;0;0;0;0;0;0
Bruno Écuélé Manga;34;Defender;Cardiff City;3375;1710;1665;Gabon;38;19;19;0;0;0;1;1;0;0;0;10;5;5;59;34;25;0;0
Bruno Saltor Grau;42;Defender;Brighton & Hove Albion;1136;534;602;Spain;14;6;8;0;0;0;1;1;0;0;0;4;2;2;17;8;9;2;0
Caglar Söyüncü;26;Defender;Leicester City;371;191;180;Turkey;6;4;2;0;0;0;0;0;0;0;0;2;2;0;3;1;2;1;0
Callum Hudson-Odoi;21;Midfielder;Chelsea;391;267;124;England;10;6;4;0;0;0;1;1;0;0;0;3;3;0;5;2;3;0;0
Callum Paterson;28;Defender;Cardiff City;1996;1024;972;Scotland;27;14;13;4;3;1;1;0;1;0;0;7;5;2;37;18;19;4;0
Callum Roberts;25;Forward;Newcastle United;0;0;0;England;0;0;0;0;0;0;0;0;0;0;0;0;0;0;0;0;0;0;0
Callum Slattery;23;Midfielder;Southampton;110;6;104;England;3;1;2;0;0;0;0;0;0;0;0;0;0;0;0;0;0;0;0
Callum Wilson;30;Forward;AFC Bournemouth;2535;1324;1211;England;30;15;15;14;5;9;9;4;5;1;1;9;5;4;44;17;27;3;0
Calum Chambers;27;Defender;Fulham;2587;1458;1129;England;31;17;14;2;2;0;0;0;0;0;0;5;3;2;49;24;25;9;0
Cameron John;23;Defender;Wolverhampton Wanderers;0;0;0;England;0;0;0;0;0;0;0;0;0;0;0;0;0;0;0;0;0;0;0
Carl Jenkinson;30;Defender;Arsenal;166;166;0;England;3;3;0;0;0;0;0;0;0;0;0;0;0;0;2;2;0;0;0
Carlos Sánchez;36;Midfielder;West Ham United;240;120;120;Colombia;7;4;3;0;0;0;0;0;0;0;0;2;2;0;2;0;2;0;0
Cedric Soares;31;Defender;Southampton;1494;651;843;Portugal;18;8;10;1;1;0;2;0;2;0;0;5;2;3;26;7;19;4;0
Cenk Tosun;31;Forward;Everton;1050;536;514;Turkey;25;13;12;3;2;1;3;1;2;0;0;7;4;3;16;9;7;3;0
Cesar Azpilicueta;33;Defender;Chelsea;3403;1693;1710;Spain;38;19;19;1;0;1;5;3;2;0;0;16;10;6;38;12;26;4;0
Cesc Fabregas;35;Midfielder;Chelsea;175;73;102;Spain;6;4;2;0;0;0;0;0;0;0;0;3;2;1;2;0;2;1;0
Charlie Austin;33;Forward;Southampton;980;454;526;England;25;13;12;2;1;1;2;1;1;0;1;6;3;3;14;6;8;1;0
Charlie Daniels;36;Defender;AFC Bournemouth;1583;803;780;England;21;11;10;1;1;0;0;0;0;0;0;6;4;2;32;14;18;4;0
Charlie Taylor;29;Defender;Burnley;3240;1636;1604;England;38;19;19;0;0;0;1;1;0;0;0;8;5;3;53;24;29;2;0
Cheikhou Kouyaté;32;Midfielder;Crystal Palace;1897;865;1032;Senegal;31;14;17;0;0;0;2;1;1;0;0;11;6;5;24;7;17;3;0
Chris Löwe;33;Defender;Huddersfield Town;2056;932;1124;Germany;29;15;14;0;0;0;2;1;1;0;0;1;1;0;52;19;33;2;0
Chris Mepham;24;Defender;AFC Bournemouth;849;436;413;Wales;13;6;7;0;0;0;1;0;1;0;0;3;1;2;16;7;9;1;0
Chris Smalling;32;Defender;Manchester United;2128;1138;990;England;24;13;11;1;0;1;0;0;0;0;0;4;2;2;34;16;18;1;0
Chris Wood;30;Forward;Burnley;2582;1330;1252;New Zealand;38;19;19;10;4;6;2;0;2;0;0;8;5;3;43;21;22;2;0
Christian Atsu Twasam;30;Midfielder;Newcastle United;1487;710;777;Ghana;28;13;15;1;1;0;0;0;0;0;0;8;3;5;16;10;6;2;0
Christian Benteke;31;Forward;Crystal Palace;813;526;287;Belgium;16;10;6;1;0;1;1;0;1;0;0;5;3;2;10;6;4;1;0
Christian Eriksen;30;Midfielder;Tottenham Hotspur;2772;1457;1315;Denmark;35;18;17;8;6;2;12;8;4;0;0;10;6;4;34;14;20;3;0
Christian Fuchs;36;Defender;Leicester City;206;90;116;Austria;3;1;2;0;0;0;0;0;0;0;0;0;0;0;4;3;1;0;0
Christian Kabasele;31;Defender;Watford;1587;957;630;Belgium;21;14;7;0;0;0;0;0;0;0;0;4;3;1;25;15;10;4;1
Christopher Schindler;32;Defender;Huddersfield Town;3262;1642;1620;Germany;37;19;18;1;0;1;0;0;0;0;0;5;3;2;69;30;39;6;1
Ciaran Clark;33;Defender;Newcastle United;857;416;441;Republic of Ireland;11;6;5;3;1;2;0;0;0;0;0;2;0;2;14;9;5;1;0
Claudio Bravo;39;Goalkeeper;Manchester City;0;0;0;Chile;0;0;0;0;0;0;0;0;0;0;0;0;0;0;0;0;0;0;0
Collin Quaner;31;Forward;Huddersfield Town;37;9;28;Germany;2;1;1;0;0;0;0;0;0;0;0;0;0;0;2;0;2;0;0
Connor Wickham;29;Forward;Crystal Palace;61;49;12;England;6;3;3;0;0;0;1;0;1;0;0;2;1;1;0;0;0;0;0
Conor Coady;29;Midfielder;Wolverhampton Wanderers;3420;1710;1710;England;38;19;19;0;0;0;0;0;0;0;0;9;7;2;43;20;23;5;0
Conor Coventry;22;Midfielder;West Ham United;0;0;0;Republic of Ireland;0;0;0;0;0;0;0;0;0;0;0;0;0;0;0;0;0;0;0
Craig Cathcart;33;Defender;Watford;3099;1561;1538;Northern Ireland;36;18;18;3;1;2;0;0;0;0;0;6;3;3;52;28;24;2;0
Curtis Jones;21;Midfielder;Liverpool;0;0;0;England;0;0;0;0;0;0;0;0;0;0;0;0;0;0;0;0;0;0;0
Cyrus Christie;30;Defender;Fulham;1943;1053;890;Republic of Ireland;28;15;13;0;0;0;1;1;0;0;0;5;3;2;40;20;20;7;0
Dale Stephens;33;Midfielder;Brighton & Hove Albion;2487;1191;1296;England;30;14;16;1;0;1;1;0;1;0;0;5;3;2;43;18;25;7;1
Dan Burn;30;Defender;Brighton & Hove Albion;0;0;0;England;0;0;0;0;0;0;0;0;0;0;0;0;0;0;0;0;0;0;0
Dan Gosling;32;Midfielder;AFC Bournemouth;1737;911;826;England;25;13;12;2;0;2;1;0;1;0;0;7;4;3;31;14;17;8;0
Daniel Amartey;27;Midfielder;Leicester City;640;307;333;Ghana;9;5;4;0;0;0;0;0;0;0;0;2;1;1;9;4;5;2;0
Daniel Sturridge;33;Forward;Liverpool;496;152;344;England;18;9;9;2;1;1;1;1;0;0;0;10;7;3;3;0;3;1;0
Daniel Williams;33;Midfielder;Huddersfield Town;93;13;80;USA;5;1;4;0;0;0;0;0;0;0;0;1;0;1;1;0;1;1;0
Danilo;31;Defender;Manchester City;806;450;356;Brazil;11;5;6;1;0;1;0;0;0;0;0;5;3;2;7;2;5;1;0
Danny Drinkwater;32;Midfielder;Chelsea;0;0;0;England;0;0;0;0;0;0;0;0;0;0;0;0;0;0;0;0;0;0;0
Danny Ings;30;Forward;Southampton;1668;922;746;England;24;13;11;7;3;4;3;3;0;3;0;6;2;4;26;13;13;1;0
Danny Rose;32;Defender;Tottenham Hotspur;1806;969;837;England;26;13;13;0;0;0;3;1;2;0;0;10;7;3;12;6;6;5;0
Danny Simpson;35;Defender;Leicester City;291;26;265;England;6;2;4;0;0;0;0;0;0;0;0;3;1;2;4;0;4;0;0
Danny Ward;29;Goalkeeper;Leicester City;0;0;0;Wales;0;0;0;0;0;0;0;0;0;0;0;0;0;0;0;0;0;0;0
Danny Ward;31;Forward;Cardiff City;440;246;194;England;14;6;8;1;1;0;0;0;0;0;0;2;0;2;11;8;3;0;0
Danny Welbeck;31;Forward;Arsenal;147;47;100;England;8;4;4;1;1;0;1;0;1;0;0;2;2;0;2;0;2;0;0
Daryl Janmaat;33;Defender;Watford;1521;836;685;Netherlands;18;10;8;0;0;0;2;2;0;0;0;3;2;1;22;8;14;3;0
David Brooks;25;Forward;AFC Bournemouth;2278;1289;989;England;30;17;13;7;4;3;5;3;2;0;0;9;5;4;39;17;22;3;0
David Button;33;Goalkeeper;Brighton & Hove Albion;360;180;180;England;4;2;2;0;0;0;0;0;0;0;0;1;1;0;5;1;4;0;0
David de Gea;31;Goalkeeper;Manchester United;3420;1710;1710;Spain;38;19;19;0;0;0;0;0;0;0;0;7;2;5;51;23;28;1;0
David Junior Hoilett;32;Forward;Cardiff City;2142;1008;1134;Canada;32;17;15;3;2;1;1;0;1;0;0;9;5;4;42;20;22;4;0
David Luiz;35;Defender;Chelsea;3239;1709;1530;Brazil;36;19;17;3;3;0;2;1;1;0;0;16;10;6;35;12;23;3;0
David Silva;36;Midfielder;Manchester City;2411;1088;1323;Spain;33;16;17;6;4;2;8;3;5;0;0;17;8;9;14;7;7;3;0
Davide Zappacosta;30;Defender;Chelsea;125;35;90;Italy;4;3;1;0;0;0;0;0;0;0;0;3;2;1;0;0;0;0;0
Davinson Sánchez;26;Defender;Tottenham Hotspur;1943;873;1070;Colombia;23;10;13;1;1;0;1;0;1;0;0;6;3;3;21;9;12;2;0
Davy Pröpper;31;Midfielder;Brighton & Hove Albion;2551;1371;1180;Netherlands;30;16;14;1;0;1;1;0;1;0;0;5;4;1;44;19;25;2;0
DeAndre Yedlin;29;Defender;Newcastle United;2475;1313;1162;USA;29;16;13;1;0;1;2;1;1;0;0;6;4;2;37;19;18;7;1
Declan Rice;23;Midfielder;West Ham United;3005;1440;1565;Republic of Ireland;34;16;18;2;2;0;0;0;0;0;0;6;3;3;42;21;21;4;0
Dejan Lovren;33;Defender;Liverpool;985;540;445;Croatia;13;7;6;1;1;0;0;0;0;0;0;6;3;3;7;3;4;1;0
Dele Alli;26;Midfielder;Tottenham Hotspur;1827;755;1072;England;25;11;14;5;1;4;3;2;1;0;0;7;3;4;17;4;13;4;0
Demarai Gray;26;Midfielder;Leicester City;1992;1069;923;England;34;17;17;4;1;3;1;1;0;0;0;8;5;3;26;10;16;2;0
Demeaco Duhaney;24;Defender;Huddersfield Town;46;46;0;England;1;1;0;0;0;0;0;0;0;0;0;1;1;0;0;0;0;0;0
Denis Odoi;34;Defender;Fulham;2593;1153;1440;Belgium;31;15;16;0;0;0;1;0;1;0;0;5;3;2;59;23;36;4;0
Denis Suárez;28;Midfielder;Arsenal;67;29;38;Spain;4;2;2;0;0;0;0;0;0;0;0;1;1;0;0;0;0;0;0
Diego Rico;29;Defender;AFC Bournemouth;607;148;459;Spain;12;4;8;0;0;0;0;0;0;0;0;0;0;0;18;3;15;1;0
Diogo Dalot;23;Defender;Manchester United;1015;525;490;Portugal;16;7;9;0;0;0;2;2;0;0;0;2;0;2;18;8;10;3;0
Diogo José Teixeira da Silva;25;Midfielder;Wolverhampton Wanderers;2371;1210;1161;Portugal;33;16;17;9;7;2;5;3;2;0;0;9;7;2;29;11;18;11;0
Divock Origi;27;Forward;Liverpool;366;176;190;Belgium;12;5;7;3;2;1;1;0;1;0;0;7;4;3;2;0;2;0;0
Domingos Quina;22;Midfielder;Watford;335;217;118;Portugal;8;5;3;1;1;0;0;0;0;0;0;1;0;1;5;3;2;0;0
Dominic Calvert-Lewin;25;Forward;Everton;1774;1023;751;England;35;18;17;6;3;3;2;2;0;0;0;13;8;5;24;12;12;3;0
Dominic Solanke;25;Forward;AFC Bournemouth;341;165;176;England;10;4;6;0;0;0;1;1;0;0;0;2;0;2;4;1;3;0;0
Dwight McNeil;22;Forward;Burnley;1599;941;658;England;21;12;9;3;3;0;5;3;2;0;0;4;3;1;22;12;10;2;0
Eden Hazard;31;Midfielder;Chelsea;2926;1527;1399;Belgium;37;19;18;16;11;5;15;10;5;4;0;15;10;5;34;9;25;2;0
Ederson;29;Goalkeeper;Manchester City;3420;1710;1710;Brazil;38;19;19;0;0;0;1;1;0;0;0;20;9;11;23;12;11;2;0
Edward Nketiah;23;Forward;Arsenal;62;4;58;England;5;1;4;1;0;1;0;0;0;0;0;1;1;0;2;0;2;0;0
Elias Kachunga;30;Forward;Huddersfield Town;1181;611;570;Congo DR;20;9;11;0;0;0;0;0;0;0;0;2;1;1;28;14;14;2;0
Emerson Hyndman;26;Midfielder;AFC Bournemouth;37;0;37;USA;1;0;1;0;0;0;0;0;0;0;0;0;0;0;2;0;2;0;0
Emerson Palmieri;28;Defender;Chelsea;660;360;300;Italy;10;4;6;0;0;0;0;0;0;0;0;3;2;1;10;3;7;0;0
Emile Smith Rowe;22;Midfielder;Arsenal;0;0;0;England;0;0;0;0;0;0;0;0;0;0;0;0;0;0;0;0;0;0;0
Emiliano Martínez;30;Goalkeeper;Arsenal;0;0;0;Argentina;0;0;0;0;0;0;0;0;0;0;0;0;0;0;0;0;0;0;0
Eric Bailly;28;Defender;Manchester United;637;349;288;Ivory Coast;12;5;7;0;0;0;0;0;0;0;0;3;0;3;12;6;6;1;1
Eric Dier;28;Midfielder;Tottenham Hotspur;1510;674;836;England;20;9;11;3;2;1;0;0;0;0;0;6;2;4;16;8;8;4;0
Erik Durm;30;Defender;Huddersfield Town;2052;869;1183;Germany;28;13;15;0;0;0;1;0;1;0;0;3;1;2;43;17;26;0;0
Erik Lamela;30;Midfielder;Tottenham Hotspur;971;493;478;Argentina;19;11;8;4;1;3;2;1;1;0;0;5;3;2;11;5;6;2;0
Ethan Ampadu;22;Midfielder;Chelsea;0;0;0;Wales;0;0;0;0;0;0;0;0;0;0;0;0;0;0;0;0;0;0;0
Étienne Capoue;34;Midfielder;Watford;2947;1518;1429;France;33;17;16;1;0;1;3;2;1;0;0;7;4;3;47;24;23;15;1
Fabián Balbuena;31;Defender;West Ham United;2014;934;1080;Paraguay;23;11;12;1;0;1;0;0;0;0;0;5;2;3;27;13;14;2;0
Fabian Delph;32;Midfielder;Manchester City;725;266;459;England;11;5;6;0;0;0;1;1;0;0;0;4;1;3;9;4;5;2;1
Fabian Schär;30;Defender;Newcastle United;2002;1173;829;Switzerland;24;14;10;4;3;1;1;0;1;0;0;8;5;3;21;14;7;12;0
Fabinho;29;Midfielder;Liverpool;2013;1051;962;Brazil;28;14;14;1;1;0;2;1;1;0;0;15;7;8;13;6;7;6;0
Fabricio Martín Agosto Ramírez;34;Goalkeeper;Fulham;180;90;90;Spain;2;1;1;0;0;0;0;0;0;0;0;0;0;0;5;2;3;0;0
Faustino Marcos Alberto Rojo;32;Defender;Manchester United;211;211;0;Argentina;5;5;0;0;0;0;0;0;0;0;0;0;0;0;4;4;0;2;0
Federico Fernández;33;Defender;Newcastle United;1484;607;877;Argentina;19;8;11;0;0;0;1;1;0;0;0;4;1;3;22;9;13;2;0
Felipe Anderson;29;Midfielder;West Ham United;3054;1439;1615;Brazil;36;17;19;9;4;5;4;2;2;0;0;6;3;3;43;21;22;3;0
Fernandinho;37;Midfielder;Manchester City;2381;1286;1095;Brazil;29;15;14;1;1;0;3;3;0;0;0;16;7;9;15;8;7;5;0
Fernando Llorente Torres;37;Forward;Tottenham Hotspur;683;508;175;Spain;20;11;9;1;1;0;4;4;0;0;0;7;5;2;8;5;3;2;0
Florent Hadergjonaj;28;Defender;Huddersfield Town;1840;1011;829;Switzerland;24;12;12;0;0;0;0;0;0;0;0;4;2;2;34;15;19;1;0
Florian Lejeune;31;Defender;Newcastle United;1055;515;540;France;12;6;6;0;0;0;0;0;0;0;0;3;3;0;12;3;9;0;0
Florin Andone;29;Forward;Brighton & Hove Albion;874;416;458;Romania;23;12;11;3;2;1;0;0;0;0;0;3;3;0;13;5;8;5;0
Floyd Ayité;33;Midfielder;Fulham;465;296;169;Togo;16;7;9;1;0;1;0;0;0;0;0;3;1;2;13;7;6;0;0
Fousseni Diabaté;27;Midfielder;Leicester City;55;0;55;Mali;1;0;1;0;0;0;0;0;0;0;0;0;0;0;1;0;1;0;0
Fraser Forster;34;Goalkeeper;Southampton;90;0;90;England;1;0;1;0;0;0;0;0;0;0;0;0;0;0;3;0;3;0;0
Fred;29;Midfielder;Manchester United;1045;577;468;Brazil;17;9;8;1;1;0;1;0;1;0;0;0;0;0;19;8;11;2;0
Freddie Woodman;25;Goalkeeper;Newcastle United;0;0;0;England;0;0;0;0;0;0;0;0;0;0;0;0;0;0;0;0;0;0;0
Gabriel Jesus;25;Forward;Manchester City;1019;702;317;Brazil;29;14;15;7;5;2;3;1;2;1;0;16;7;9;11;7;4;1;0
Gaëtan Bong Songo;34;Defender;Brighton & Hove Albion;1805;720;1085;Cameroon;22;8;14;0;0;0;0;0;0;0;0;5;3;2;32;9;23;0;0
Gary Cahill;36;Defender;Chelsea;22;1;21;England;2;1;1;0;0;0;0;0;0;0;0;2;1;1;0;0;0;0;0
Gary Madine;32;Forward;Cardiff City;32;17;15;England;5;3;2;0;0;0;0;0;0;0;0;0;0;0;2;0;2;0;0
George Marsh;23;Midfielder;Tottenham Hotspur;0;0;0;England;0;0;0;0;0;0;0;0;0;0;0;0;0;0;0;0;0;0;0
Georges-Kevin N'Koudou Mbida;27;Forward;Tottenham Hotspur;4;0;4;France;1;0;1;0;0;0;1;0;1;0;0;0;0;0;0;0;0;0;0
Georginio Wijnaldum;31;Midfielder;Liverpool;2735;1413;1322;Netherlands;35;18;17;3;1;2;0;0;0;0;0;21;12;9;15;6;9;3;0
Gerard Deulofeu;28;Forward;Watford;2082;949;1133;Spain;30;14;16;10;3;7;5;3;2;0;0;6;3;3;28;11;17;3;0
Glenn Murray;39;Forward;Brighton & Hove Albion;2513;1383;1130;England;38;19;19;13;8;5;1;1;0;4;0;7;5;2;44;22;22;5;0
Gonzalo Higuain;34;Forward;Chelsea;1092;496;596;Argentina;14;6;8;5;4;1;0;0;0;0;0;5;4;1;15;3;12;0;0
Grady Diangana;24;Midfielder;West Ham United;604;326;278;England;17;9;8;0;0;0;1;1;0;0;0;2;1;1;11;8;3;0;0
Granit Xhaka;30;Midfielder;Arsenal;2502;1317;1185;Switzerland;29;15;14;4;2;2;2;0;2;0;0;7;6;1;35;11;24;10;0
Greg Cunningham;31;Defender;Cardiff City;630;450;180;Republic of Ireland;7;5;2;0;0;0;0;0;0;0;0;1;0;1;16;15;1;3;0
Gylfi Sigurdsson;33;Midfielder;Everton;3134;1602;1532;Iceland;38;19;19;13;7;6;6;2;4;2;3;14;9;5;40;19;21;3;0
Hamza Choudhury;25;Midfielder;Leicester City;596;308;288;England;9;4;5;0;0;0;0;0;0;0;0;4;2;2;4;3;1;0;0
Harry Arter;32;Midfielder;Cardiff City;2008;1186;822;Republic of Ireland;25;14;11;0;0;0;1;1;0;0;0;7;4;3;37;25;12;10;0
Harry Kane;29;Forward;Tottenham Hotspur;2427;1066;1361;England;28;12;16;17;6;11;4;2;2;4;0;10;4;6;28;10;18;5;0
Harry Maguire;29;Defender;Leicester City;2599;1350;1249;England;31;15;16;3;0;3;0;0;0;0;0;7;3;4;36;16;20;7;1
Harry Winks;26;Midfielder;Tottenham Hotspur;1591;832;759;England;26;13;13;1;0;1;0;0;0;0;0;10;4;6;16;8;8;4;0
Harvey Barnes;24;Midfielder;Leicester City;1007;601;406;England;16;9;7;1;0;1;2;2;0;0;0;3;3;0;16;7;9;0;0
Håvard Nordtveit;32;Midfielder;Fulham;361;90;271;Norway;5;1;4;0;0;0;1;0;1;0;0;1;0;1;9;2;7;0;0
Hector Bellerin;27;Defender;Arsenal;1535;882;653;Spain;19;10;9;0;0;0;5;4;1;0;0;4;4;0;20;8;12;3;0
Hélder Wander Sousa Azevedo Costa;28;Midfielder;Wolverhampton Wanderers;1345;657;688;Portugal;25;11;14;1;0;1;2;1;1;0;0;5;3;2;18;10;8;3;0
Henrikh Mkhitaryan;33;Midfielder;Arsenal;1643;650;993;Armenia;25;11;14;6;3;3;4;3;1;0;0;4;3;1;25;9;16;1;0
Heung-Min Son;30;Forward;Tottenham Hotspur;2048;1161;887;South Korea;31;16;15;12;8;4;6;2;4;0;0;11;7;4;20;8;12;3;1
Heurelho da Silva Gomes;41;Goalkeeper;Watford;0;0;0;Brazil;0;0;0;0;0;0;0;0;0;0;0;0;0;0;0;0;0;0;0
Hugo Lloris;35;Goalkeeper;Tottenham Hotspur;2970;1620;1350;France;33;18;15;0;0;0;0;0;0;0;0;12;7;5;30;13;17;0;0
Ibrahima Cissé;28;Midfielder;Fulham;87;9;78;Belgium;3;1;2;0;0;0;0;0;0;0;0;0;0;0;3;0;3;0;0
Idrissa Gueye;33;Midfielder;Everton;2825;1407;1418;Senegal;33;16;17;0;0;0;2;1;1;0;0;13;9;4;29;10;19;6;0
İlkay Gündoğan;32;Midfielder;Manchester City;2135;985;1150;Germany;31;15;16;6;4;2;3;0;3;0;0;15;6;9;15;8;7;3;0
Isaac Hayden;27;Midfielder;Newcastle United;1886;904;982;England;25;11;14;1;0;1;4;4;0;0;0;7;3;4;25;12;13;4;1
Isaac Mbenza;26;Forward;Huddersfield Town;981;589;392;Belgium;22;13;9;1;1;0;1;1;0;0;0;4;2;2;25;15;10;1;0
Isaac Success;26;Forward;Watford;1037;461;576;Nigeria;30;15;15;1;1;0;1;0;1;0;0;5;3;2;20;8;12;4;0
Issa Diop;25;Defender;West Ham United;2970;1530;1440;France;33;17;16;1;1;0;0;0;0;0;0;7;4;3;38;20;18;4;0
Ivan Ricardo Neves Abreu Cavaleiro;29;Forward;Wolverhampton Wanderers;683;331;352;Portugal;23;13;10;3;2;1;1;0;1;0;0;5;4;1;10;7;3;1;0
Jack Cork;33;Midfielder;Burnley;3313;1693;1620;England;37;19;18;1;1;0;2;1;1;0;0;8;5;3;54;27;27;6;0
Jack Simpson;25;Defender;AFC Bournemouth;403;240;163;England;6;3;3;0;0;0;0;0;0;0;0;2;1;1;9;2;7;0;0
Jack Stephens;28;Defender;Southampton;1697;816;881;England;24;10;14;1;1;0;0;0;0;0;0;5;2;3;30;11;19;4;0
Jack Wilshere;30;Midfielder;West Ham United;389;181;208;England;8;4;4;0;0;0;1;0;1;0;0;2;1;1;8;2;6;2;0
Jacob Murphy;27;Midfielder;Newcastle United;300;167;133;England;9;3;6;0;0;0;1;0;1;0;0;1;0;1;7;3;4;0;0
Jaïro Riedewald;26;Defender;Crystal Palace;0;0;0;Netherlands;0;0;0;0;0;0;0;0;0;0;0;0;0;0;0;0;0;0;0
Jamaal Lascelles;28;Defender;Newcastle United;2748;1308;1440;England;32;16;16;0;0;0;1;1;0;0;0;11;5;6;33;16;17;4;0
James Garner;21;Defender;Manchester United;0;0;0;England;1;0;1;0;0;0;0;0;0;0;0;0;0;0;0;0;0;0;0
James Maddison;25;Midfielder;Leicester City;2850;1535;1315;England;36;18;18;7;3;4;7;4;3;1;1;8;5;3;39;18;21;5;1
James McArthur;35;Midfielder;Crystal Palace;3071;1506;1565;Scotland;38;19;19;3;1;2;6;1;5;0;0;12;7;5;44;19;25;7;0
James McCarthy;31;Midfielder;Everton;14;14;0;Republic of Ireland;1;1;0;0;0;0;0;0;0;0;0;1;1;0;0;0;0;0;0
James Milner;36;Midfielder;Liverpool;1785;646;1139;England;31;12;19;5;0;5;4;2;2;3;0;18;9;9;11;4;7;7;1
James Tarkowski;29;Defender;Burnley;3087;1620;1467;England;35;18;17;3;2;1;1;1;0;0;0;7;5;2;52;25;27;8;0
James Tomkins;33;Defender;Crystal Palace;2563;1140;1423;England;29;13;16;1;0;1;1;0;1;0;0;10;5;5;34;12;22;6;0
James Ward-Prowse;27;Midfielder;Southampton;1942;942;1000;England;26;13;13;7;5;2;0;0;0;1;0;4;2;2;36;15;21;4;0
Jamie Sterry;26;Defender;Newcastle United;0;0;0;England;0;0;0;0;0;0;0;0;0;0;0;0;0;0;0;0;0;0;0
Jamie Vardy;35;Forward;Leicester City;2735;1418;1317;England;34;17;17;18;8;10;4;3;1;4;1;10;6;4;33;13;20;4;1
Jan Bednarek;26;Defender;Southampton;2151;1126;1025;Poland;25;13;12;0;0;0;1;0;1;0;0;3;1;2;33;19;14;7;0
Jan Vertonghen;35;Defender;Tottenham Hotspur;1915;884;1031;Belgium;22;10;12;1;0;1;0;0;0;0;0;7;4;3;21;7;14;5;1
Jannik Vestergaard;30;Defender;Southampton;2030;1130;900;Denmark;23;13;10;0;0;0;0;0;0;0;0;4;2;2;27;14;13;2;0
Jason Puncheon;36;Midfielder;Huddersfield Town;391;248;143;England;11;6;5;0;0;0;0;0;0;0;0;3;2;1;8;6;2;1;0
Jason Steele;32;Goalkeeper;Brighton & Hove Albion;0;0;0;England;0;0;0;0;0;0;0;0;0;0;0;0;0;0;0;0;0;0;0
Javier Hernandez;34;Forward;West Ham United;1335;694;641;Mexico;25;13;12;7;5;2;1;0;1;0;0;3;1;2;16;8;8;2;0
Javier Manquillo;28;Defender;Newcastle United;1097;503;594;Spain;18;9;9;0;0;0;3;2;1;0;0;6;3;3;12;6;6;2;0
Jayson Molumby;23;Midfielder;Brighton & Hove Albion;0;0;0;Republic of Ireland;0;0;0;0;0;0;0;0;0;0;0;0;0;0;0;0;0;0;0
Jazz Richards;31;Defender;Cardiff City;128;52;76;Wales;4;2;2;0;0;0;0;0;0;0;0;1;0;1;4;2;2;0;0
Jean Michau00ebl Seri;31;Midfielder;Fulham;2252;1112;1140;Ivory Coast;32;15;17;1;1;0;2;0;2;0;0;4;2;2;53;23;30;6;0
Jeff Hendrick;30;Midfielder;Burnley;2069;898;1171;Republic of Ireland;32;15;17;3;1;2;0;0;0;0;0;6;3;3;41;18;23;4;0
Jefferson Lerma;28;Midfielder;AFC Bournemouth;2511;1319;1192;Colombia;30;15;15;2;0;2;0;0;0;0;0;8;4;4;45;18;27;12;0
Jeffrey Schlupp;29;Defender;Crystal Palace;1665;849;816;Ghana;30;14;16;4;1;3;1;1;0;0;0;8;4;4;24;11;13;1;0
Jermain Defoe;40;Forward;AFC Bournemouth;21;0;21;England;4;1;3;0;0;0;0;0;0;0;0;2;1;1;2;0;2;0;0
Jesse Lingard;29;Midfielder;Manchester United;1668;963;705;England;27;15;12;4;1;3;2;1;1;1;0;6;2;4;25;16;9;3;0
João Moutinho;36;Midfielder;Wolverhampton Wanderers;3040;1532;1508;Portugal;38;19;19;1;0;1;8;5;3;0;0;9;7;2;37;17;20;4;0
Joe Bennett;32;Defender;Cardiff City;2641;1142;1499;England;30;13;17;0;0;0;1;1;0;0;0;9;5;4;43;18;25;5;0
Joe Bryan;29;Defender;Fulham;2350;1214;1136;England;28;15;13;0;0;0;1;1;0;0;0;5;3;2;51;21;30;5;0
Joe Daniel Tupper;24;Goalkeeper;Crystal Palace;0;0;0;England;0;0;0;0;0;0;0;0;0;0;0;0;0;0;0;0;0;0;0
Joe Gomez;25;Defender;Liverpool;1060;493;567;England;16;8;8;0;0;0;0;0;0;0;0;11;8;3;3;0;3;2;0
Joe Hart;35;Goalkeeper;Burnley;1710;810;900;England;19;9;10;0;0;0;0;0;0;0;0;4;2;2;34;17;17;0;0
Joe Powell;24;Forward;West Ham United;0;0;0;England;0;0;0;0;0;0;0;0;0;0;0;0;0;0;0;0;0;0;0
Joe Ralls;29;Midfielder;Cardiff City;1959;847;1112;England;28;15;13;0;0;0;0;0;0;0;1;8;5;3;35;17;18;5;1
Joel Coleman;27;Goalkeeper;Huddersfield Town;90;0;90;England;1;0;1;0;0;0;0;0;0;0;0;0;0;0;1;0;1;0;0
Joel Matip;31;Defender;Liverpool;1532;811;721;Cameroon;22;10;12;1;1;0;0;0;0;0;0;11;6;5;9;5;4;3;0
Joel Ward;32;Defender;Crystal Palace;551;191;360;England;7;3;4;1;1;0;0;0;0;0;0;0;0;0;12;6;6;1;0
Johann Berg Guðmunds­son;32;Midfielder;Burnley;1748;847;901;Iceland;29;15;14;3;0;3;6;5;1;0;0;6;4;2;31;13;18;2;0
John Ruddy;36;Goalkeeper;Wolverhampton Wanderers;90;90;0;England;1;1;0;0;0;0;0;0;0;0;0;1;1;0;0;0;0;0;0
John Stones;28;Defender;Manchester City;1762;968;794;England;24;12;12;0;0;0;0;0;0;0;0;13;6;7;15;8;7;1;0
Jon Gorenc Stankovič;26;Defender;Huddersfield Town;718;218;500;Slovenia;11;3;8;1;0;1;0;0;0;0;0;2;1;1;19;3;16;2;0
Jonas Lössl;33;Goalkeeper;Huddersfield Town;2777;1427;1350;Denmark;31;16;15;0;0;0;1;1;0;0;0;5;3;2;52;22;30;1;0
Jonathan Hogg;33;Midfielder;Huddersfield Town;2377;1294;1083;England;29;16;13;0;0;0;1;1;0;0;0;5;3;2;42;23;19;9;1
Jonathan Walters;39;Forward;Burnley;0;0;0;Republic of Ireland;0;0;0;0;0;0;0;0;0;0;0;0;0;0;0;0;0;0;0
Jonjo Shelvey;30;Midfielder;Newcastle United;944;403;541;England;16;8;8;1;0;1;1;0;1;0;0;5;1;4;11;8;3;1;0
Jonjoe Kenny;25;Defender;Everton;790;413;377;England;10;5;5;0;0;0;1;1;0;0;0;2;1;1;14;7;7;1;0
Jonny;28;Defender;Wolverhampton Wanderers;2780;1269;1511;Spain;33;16;17;1;1;0;1;1;0;0;0;8;6;2;36;16;20;6;0
Jonny Evans;34;Defender;Leicester City;1995;1074;921;Northern Ireland;24;12;12;1;1;0;0;0;0;0;0;8;6;2;22;9;13;2;0
Jordan Ayew;31;Forward;Crystal Palace;1186;616;570;Ghana;20;8;12;1;0;1;2;0;2;0;0;6;3;3;13;7;6;3;0
Jordan Henderson;32;Midfielder;Liverpool;1983;925;1058;England;32;16;16;1;0;1;3;2;1;0;0;19;10;9;11;4;7;3;1
Jordan Pickford;28;Goalkeeper;Everton;3420;1710;1710;England;38;19;19;0;0;0;0;0;0;0;0;14;9;5;44;20;24;1;0
Jordon Ibe;26;Midfielder;AFC Bournemouth;795;334;461;England;19;10;9;1;0;1;1;1;0;0;0;4;4;0;21;3;18;1;0
Jorginho;30;Midfielder;Chelsea;3165;1621;1544;Italy;37;19;18;2;0;2;0;0;0;1;0;16;10;6;36;12;24;8;0
José Holebas;38;Defender;Watford;2394;1224;1170;Greece;28;15;13;3;2;1;6;5;1;0;0;5;3;2;38;20;18;13;1
Jose Izquierdo;30;Forward;Brighton & Hove Albion;794;365;429;Colombia;15;8;7;0;0;0;1;0;1;0;0;5;3;2;8;4;4;1;0
Joselu;32;Forward;Newcastle United;586;308;278;Spain;16;9;7;2;2;0;0;0;0;0;0;4;2;2;12;8;4;1;0
Joseph Willock;23;Midfielder;Arsenal;64;0;64;England;2;0;2;0;0;0;0;0;0;0;0;0;0;0;0;0;0;0;0
Josh Benson;22;Midfielder;Burnley;0;0;0;England;0;0;0;0;0;0;0;0;0;0;0;0;0;0;0;0;0;0;0
Josh Knight;25;Defender;Leicester City;0;0;0;England;0;0;0;0;0;0;0;0;0;0;0;0;0;0;0;0;0;0;0
Josh Murphy;27;Forward;Cardiff City;1825;1123;702;England;29;17;12;3;2;1;2;1;1;0;0;7;4;3;27;20;7;2;0
Joshua King;30;Forward;AFC Bournemouth;2974;1563;1411;Norway;35;18;17;12;9;3;3;3;0;5;1;9;6;3;54;20;34;3;0
Joshua Sims;25;Midfielder;Southampton;209;139;70;England;7;4;3;0;0;0;1;1;0;0;0;1;0;1;5;3;2;0;0
Juan Foyth;24;Defender;Tottenham Hotspur;930;450;480;Argentina;12;6;6;1;0;1;0;0;0;0;0;4;3;1;10;2;8;4;1
Juan Mata;34;Midfielder;Manchester United;1294;833;461;Spain;22;13;9;3;3;0;2;2;0;0;0;4;2;2;14;6;8;3;0
Julián Speroni;43;Goalkeeper;Crystal Palace;90;0;90;Argentina;1;0;1;0;0;0;0;0;0;0;0;0;0;0;3;0;3;0;0
Juninho Bacuna;25;Midfielder;Huddersfield Town;1414;722;692;Netherlands;21;11;10;1;0;1;0;0;0;0;0;2;2;0;36;15;21;4;0
Junior Stanislas;32;Midfielder;AFC Bournemouth;1027;559;468;England;23;12;11;2;1;1;3;3;0;1;0;7;4;3;24;8;16;1;0
Jürgen Locadia;28;Forward;Brighton & Hove Albion;1227;590;637;Netherlands;26;14;12;2;2;0;0;0;0;0;0;4;3;1;19;9;10;1;0
Kadeem Harris;29;Midfielder;Cardiff City;366;133;233;England;13;5;8;1;1;0;0;0;0;0;0;4;1;3;5;1;4;1;0
Karl Darlow;32;Goalkeeper;Newcastle United;0;0;0;England;0;0;0;0;0;0;0;0;0;0;0;0;0;0;0;0;0;0;0
Karlan Ahearne-Grant;24;Forward;Huddersfield Town;874;331;543;England;13;6;7;4;2;2;0;0;0;0;0;1;1;0;22;7;15;0;0
Kasper Schmeichel;35;Goalkeeper;Leicester City;3420;1710;1710;Denmark;38;19;19;0;0;0;0;0;0;0;0;10;6;4;43;18;25;3;0
Kayne Ramsey;22;Midfielder;Southampton;90;90;0;England;1;1;0;0;0;0;0;0;0;0;0;0;0;0;3;3;0;0;0
Kazaiah Sterling;23;Forward;Tottenham Hotspur;0;0;0;England;0;0;0;0;0;0;0;0;0;0;0;0;0;0;0;0;0;0;0
Kelechi Iheanacho;26;Forward;Leicester City;926;408;518;Nigeria;30;14;16;1;1;0;3;2;1;0;0;6;4;2;11;5;6;2;0
Kelland Watts;23;Midfielder;Newcastle United;0;0;0;England;0;0;0;0;0;0;0;0;0;0;0;0;0;0;0;0;0;0;0
Ken Sema;29;Midfielder;Watford;755;301;454;Sweden;17;8;9;1;0;1;2;1;1;0;0;6;4;2;8;3;5;1;0
Kenneth Dahrup Zohorè;28;Forward;Cardiff City;746;388;358;Denmark;19;11;8;1;0;1;1;0;1;0;0;5;2;3;15;9;6;1;0
Kepa Arrizabalaga;28;Goalkeeper;Chelsea;3240;1620;1620;Spain;36;18;18;0;0;0;0;0;0;0;0;14;9;5;38;12;26;2;0
Kevin De Bruyne;31;Midfielder;Manchester City;974;477;497;Belgium;19;9;10;2;2;0;2;0;2;0;0;12;6;6;3;1;2;2;0
Kevin Long;32;Defender;Burnley;513;90;423;Republic of Ireland;6;1;5;0;0;0;1;0;1;0;0;1;0;1;7;2;5;0;0
Kevin McDonald;33;Midfielder;Fulham;842;399;443;Scotland;15;8;7;0;0;0;0;0;0;0;0;0;0;0;25;12;13;6;1
Ki Sung-yueng;33;Midfielder;Newcastle United;1302;824;478;South Korea;18;10;8;0;0;0;1;1;0;0;0;5;2;3;18;12;6;2;0
Kieran Dowell;25;Midfielder;Everton;0;0;0;England;0;0;0;0;0;0;0;0;0;0;0;0;0;0;0;0;0;0;0
Kieran Trippier;32;Defender;Tottenham Hotspur;2278;1188;1090;England;27;14;13;1;1;0;3;0;3;0;0;10;5;5;20;10;10;2;0
Kiko Femenía;31;Midfielder;Watford;2045;1011;1034;Spain;29;14;15;1;1;0;1;1;0;0;0;5;3;2;38;21;17;1;0
Konstantinos Mavropanos;24;Defender;Arsenal;150;46;104;Greece;4;1;3;0;0;0;0;0;0;0;0;1;0;1;1;1;0;1;0
Kortney Hause;27;Defender;Wolverhampton Wanderers;0;0;0;England;0;0;0;0;0;0;0;0;0;0;0;0;0;0;0;0;0;0;0
Kurt Zouma;28;Defender;Everton;2610;1350;1260;France;32;16;16;2;1;1;2;0;2;0;0;11;8;3;37;17;20;5;1
Kyle Taylor;23;Midfielder;AFC Bournemouth;0;0;0;England;0;0;0;0;0;0;0;0;0;0;0;0;0;0;0;0;0;0;0
Kyle Walker;32;Defender;Manchester City;2777;1245;1532;England;33;15;18;1;1;0;1;0;1;0;0;18;7;11;17;9;8;3;0
Kyle Walker-Peters;25;Defender;Tottenham Hotspur;374;272;102;England;6;4;2;0;0;0;3;3;0;0;0;3;2;1;4;2;2;1;0
Laurent Depoitre;33;Forward;Huddersfield Town;1059;446;613;Belgium;23;12;11;0;0;0;1;0;1;0;0;3;2;1;22;6;16;1;0
Laurent Koscielny;37;Defender;Arsenal;1328;484;844;France;17;6;11;3;2;1;0;0;0;0;0;4;3;1;21;5;16;1;0
Lazar Marković;28;Midfielder;Fulham;44;0;44;Serbia;1;0;1;0;0;0;0;0;0;0;0;0;0;0;0;0;0;0;0
Leander Dendoncker;27;Midfielder;Wolverhampton Wanderers;1469;635;834;Belgium;19;9;10;2;1;1;0;0;0;0;0;4;4;0;19;6;13;1;0
Leandro Bacuna;31;Midfielder;Cardiff City;554;302;252;Curaçao;11;6;5;0;0;0;0;0;0;0;0;4;2;2;11;10;1;2;0
Lee Grant;39;Goalkeeper;Manchester United;0;0;0;England;0;0;0;0;0;0;0;0;0;0;0;0;0;0;0;0;0;0;0
Lee Peltier;35;Defender;Cardiff City;1542;521;1021;England;20;7;13;0;0;0;0;0;0;0;0;6;2;4;21;9;12;4;0
Leighton Baines;37;Defender;Everton;376;141;235;England;6;3;3;0;0;0;0;0;0;0;0;1;0;1;6;2;4;0;0
Leon Balogun;34;Defender;Brighton & Hove Albion;591;309;282;Nigeria;8;4;4;1;1;0;0;0;0;0;0;0;0;0;9;5;4;2;0
Leonardo Bonatini Lohner Maia;28;Forward;Wolverhampton Wanderers;128;61;67;Brazil;7;4;3;0;0;0;1;0;1;0;0;3;2;1;0;0;0;0;0
Leroy Sané;26;Midfielder;Manchester City;1867;1024;843;Germany;31;16;15;10;5;5;10;6;4;0;0;16;8;8;14;8;6;1;0
Lewis Cass;22;Defender;Newcastle United;0;0;0;England;0;0;0;0;0;0;0;0;0;0;0;0;0;0;0;0;0;0;0
Lewis Cook;25;Midfielder;AFC Bournemouth;721;381;340;England;13;7;6;0;0;0;0;0;0;0;0;3;1;2;10;5;5;2;0
Lewis Dunk;30;Defender;Brighton & Hove Albion;3153;1550;1603;England;36;18;18;2;0;2;1;0;1;0;0;7;5;2;53;24;29;7;1
Loïc Damour;31;Midfielder;Cardiff City;21;4;17;France;2;1;1;0;0;0;0;0;0;0;0;0;0;0;2;0;2;0;0
Loris Karius;29;Goalkeeper;Liverpool;0;0;0;Germany;0;0;0;0;0;0;0;0;0;0;0;0;0;0;0;0;0;0;0
Luca de la Torre;24;Midfielder;Fulham;0;0;0;USA;0;0;0;0;0;0;0;0;0;0;0;0;0;0;0;0;0;0;0
Lucas Digne;29;Defender;Everton;2990;1511;1479;France;35;17;18;4;2;2;4;2;2;0;0;14;9;5;36;16;20;6;1
Lucas Moura;30;Midfielder;Tottenham Hotspur;2127;1040;1087;Brazil;32;15;17;10;6;4;0;0;0;0;0;12;7;5;16;9;7;3;0
Lucas Perez;34;Forward;West Ham United;468;287;181;Spain;15;10;5;3;3;0;0;0;0;0;0;3;2;1;9;5;4;0;0
Lucas Torreira;26;Midfielder;Arsenal;2377;1231;1146;Uruguay;34;17;17;2;2;0;2;0;2;0;0;6;5;1;35;10;25;8;1
Luciano Vietto;28;Forward;Fulham;983;549;434;Argentina;20;9;11;1;1;0;4;4;0;0;0;1;1;0;21;11;10;1;0
Luka Milivojević;31;Midfielder;Crystal Palace;3420;1710;1710;Serbia;38;19;19;12;7;5;2;0;2;10;1;12;7;5;47;20;27;10;0
Luke Amos;25;Midfielder;Tottenham Hotspur;2;0;2;England;1;0;1;0;0;0;0;0;0;0;0;0;0;0;0;0;0;0;0
Luke Dreher;23;Midfielder;Crystal Palace;0;0;0;England;1;1;0;0;0;0;0;0;0;0;0;0;0;0;0;0;0;0;0
Luke Shaw;27;Defender;Manchester United;2592;1170;1422;England;29;13;16;1;1;0;4;2;2;0;0;6;1;5;36;16;20;11;0
Lys Mousset;26;Forward;AFC Bournemouth;345;96;249;France;24;13;11;1;0;1;0;0;0;0;0;5;4;1;13;4;9;1;0
Maarten Stekelenburg;40;Goalkeeper;Everton;0;0;0;Netherlands;0;0;0;0;0;0;0;0;0;0;0;0;0;0;0;0;0;0;0
Mamadou Sakho;32;Defender;Crystal Palace;2417;1170;1247;France;27;13;14;0;0;0;0;0;0;0;0;9;5;4;32;10;22;2;0
Manolo Gabbiadini;30;Forward;Southampton;470;253;217;Italy;12;6;6;1;1;0;0;0;0;0;0;3;2;1;11;3;8;0;0
Manuel Lanzini;29;Midfielder;West Ham United;688;367;321;Argentina;10;5;5;1;0;1;1;0;1;0;0;2;2;0;11;5;6;2;0
Marc Albrighton;32;Midfielder;Leicester City;1626;797;829;England;27;14;13;2;1;1;2;1;1;0;0;9;5;4;17;8;9;3;0
Marc Guehi;22;Defender;Chelsea;0;0;0;England;0;0;0;0;0;0;0;0;0;0;0;0;0;0;0;0;0;0;0
Marc Navarro Ceciliano;27;Defender;Watford;84;0;84;Spain;2;0;2;0;0;0;0;0;0;0;0;0;0;0;2;0;2;0;0
Marc Pugh;35;Midfielder;AFC Bournemouth;0;0;0;England;0;0;0;0;0;0;0;0;0;0;0;0;0;0;0;0;0;0;0
Marcos Alonso;31;Defender;Chelsea;2761;1338;1423;Spain;31;15;16;2;1;1;4;3;1;0;0;14;8;6;28;9;19;6;0
Marcus Bettinelli;30;Goalkeeper;Fulham;630;270;360;England;7;3;4;0;0;0;0;0;0;0;0;0;0;0;19;7;12;1;0
Marcus Rashford;25;Forward;Manchester United;2362;1293;1069;England;33;17;16;10;4;6;6;3;3;0;0;6;2;4;34;17;17;4;1
Mario Lemina;29;Midfielder;Southampton;1615;763;852;Gabon;21;9;12;1;0;1;1;0;1;0;0;4;2;2;32;12;20;5;0
Mark Noble;35;Midfielder;West Ham United;2308;1147;1161;England;31;15;16;5;2;3;5;4;1;4;0;7;4;3;29;12;17;7;1
Mark Travers;23;Goalkeeper;AFC Bournemouth;180;90;90;Republic of Ireland;2;1;1;0;0;0;0;0;0;0;0;1;1;0;5;0;5;0;0
Marko Arnautović;33;Forward;West Ham United;2000;1083;917;Austria;28;15;13;10;7;3;4;1;3;1;0;5;3;2;31;17;14;3;0
Markus Suttner;35;Defender;Brighton & Hove Albion;0;0;0;Austria;0;0;0;0;0;0;0;0;0;0;0;0;0;0;0;0;0;0;0
Marouane Fellaini;34;Midfielder;Manchester United;744;217;527;Belgium;14;6;8;0;0;0;1;0;1;0;0;2;1;1;13;2;11;1;0
Martin Dúbravka;33;Goalkeeper;Newcastle United;3420;1710;1710;Slovakia;38;19;19;0;0;0;0;0;0;0;0;11;5;6;44;23;21;1;0
Martin Kelly;32;Defender;Crystal Palace;1110;660;450;England;13;8;5;0;0;0;0;0;0;0;0;3;2;1;18;11;7;2;0
Martín Montoya;31;Defender;Brighton & Hove Albion;2166;1176;990;Spain;25;14;11;0;0;0;1;0;1;0;0;3;3;0;38;18;20;4;0
Mason Greenwood;21;Midfielder;Manchester United;115;105;10;England;3;2;1;0;0;0;0;0;0;0;0;0;0;0;2;2;0;0;0
Mason Holgate;26;Defender;Everton;407;270;137;England;5;3;2;0;0;0;0;0;0;0;0;0;0;0;9;5;4;1;0
Matěj Vydra;30;Forward;Burnley;311;91;220;Czech Republic;13;6;7;1;1;0;1;0;1;0;0;1;1;0;4;0;4;1;0
Mateo Kovačić;28;Midfielder;Chelsea;1743;968;775;Croatia;32;17;15;0;0;0;2;1;1;0;0;12;8;4;18;4;14;3;0
Mathew Ryan;30;Goalkeeper;Brighton & Hove Albion;3060;1530;1530;Australia;34;17;17;0;0;0;0;0;0;0;0;6;4;2;52;25;27;2;0
Mathias Jørgensen;32;Defender;Huddersfield Town;2148;1248;900;Denmark;24;14;10;3;1;2;1;0;1;0;0;3;2;1;37;21;16;6;0
Matt Butcher;25;Midfielder;AFC Bournemouth;0;0;0;England;0;0;0;0;0;0;0;0;0;0;0;0;0;0;0;0;0;0;0
Matt Doherty;30;Defender;Wolverhampton Wanderers;3147;1557;1590;Republic of Ireland;38;19;19;4;1;3;5;4;1;0;0;9;7;2;38;18;20;5;0
Matt Ritchie;33;Midfielder;Newcastle United;2940;1557;1383;Scotland;36;19;17;2;1;1;8;2;6;1;1;11;5;6;37;21;16;9;0
Matt Targett;27;Defender;Southampton;1185;483;702;England;16;7;9;1;1;0;3;2;1;0;0;1;0;1;24;10;14;2;0
Matteo Darmian;32;Defender;Manchester United;443;353;90;Italy;6;5;1;0;0;0;0;0;0;0;0;1;1;0;7;4;3;0;0
Matteo Guendouzi;23;Midfielder;Arsenal;2143;971;1172;France;33;14;19;0;0;0;0;0;0;0;0;4;3;1;28;9;19;9;0
Matthew Connolly;35;Defender;Cardiff City;0;0;0;England;0;0;0;0;0;0;0;0;0;0;0;0;0;0;0;0;0;0;0
Matthew Lowton;33;Defender;Burnley;1748;810;938;England;21;9;12;0;0;0;0;0;0;0;0;4;2;2;35;16;19;7;0
Matty Daly;21;Midfielder;Huddersfield Town;73;49;24;England;2;1;1;0;0;0;0;0;0;0;0;0;0;0;1;1;0;0;0
Max Harrison Sanders;23;Midfielder;Brighton & Hove Albion;0;0;0;England;0;0;0;0;0;0;0;0;0;0;0;0;0;0;0;0;0;0;0
Max Kilman;25;Defender;Wolverhampton Wanderers;0;0;0;England;1;1;0;0;0;0;0;0;0;0;0;1;1;0;0;0;0;0;0
Max Meyer;27;Midfielder;Crystal Palace;1414;718;696;Germany;29;18;11;1;0;1;2;0;2;0;0;8;7;1;19;5;14;3;0
Maxime Le Marchand;33;Defender;Fulham;2251;1171;1080;France;26;14;12;0;0;0;1;1;0;0;0;4;3;1;50;23;27;5;0
Maya Yoshida;34;Defender;Southampton;1520;800;720;Japan;17;9;8;0;0;0;1;1;0;0;0;3;1;2;27;14;13;0;0
Mesut Özil;34;Midfielder;Arsenal;1741;1139;602;Germany;24;14;10;5;4;1;2;2;0;0;0;6;5;1;23;11;12;2;0
Michael Keane;29;Defender;Everton;2970;1350;1620;England;33;15;18;1;0;1;2;1;1;0;0;13;8;5;37;15;22;2;0
Michael Obafemi;22;Forward;Southampton;134;64;70;Republic of Ireland;6;2;4;1;0;1;1;1;0;0;0;0;0;0;2;2;0;1;0
Michail Antonio;32;Midfielder;West Ham United;2099;998;1101;England;33;16;17;6;4;2;4;2;2;0;0;5;3;2;26;10;16;3;0
Michel Vorm;39;Goalkeeper;Tottenham Hotspur;180;90;90;Netherlands;2;1;1;0;0;0;0;0;0;0;0;0;0;0;4;2;2;0;0
Michy Batshuayi;29;Forward;Crystal Palace;756;368;388;Belgium;11;6;5;5;2;3;0;0;0;0;0;3;2;1;11;7;4;0;0
Miguel Almirón;28;Midfielder;Newcastle United;763;405;358;Paraguay;10;5;5;0;0;0;0;0;0;0;0;3;2;1;10;4;6;0;0
Miguel Ángel Britos Cabrera;37;Defender;Watford;185;13;172;Uruguay;3;1;2;0;0;0;0;0;0;0;0;1;1;0;5;0;5;0;0
Mohamed Diamé;35;Midfielder;Newcastle United;2165;960;1205;Senegal;29;13;16;0;0;0;0;0;0;0;0;9;3;6;28;13;15;3;0
Mohamed Elneny;30;Midfielder;Arsenal;381;214;167;Egypt;8;5;3;0;0;0;0;0;0;0;0;2;2;0;4;2;2;0;0
Mohamed Elyounoussi;28;Midfielder;Southampton;790;393;397;Norway;16;8;8;0;0;0;0;0;0;0;0;4;2;2;8;5;3;0;0
Mohamed Salah;30;Forward;Liverpool;3262;1692;1570;Egypt;38;19;19;22;13;9;8;5;3;3;0;21;12;9;18;8;10;1;0
Morgan Gibbs-White;22;Midfielder;Wolverhampton Wanderers;647;426;221;England;26;13;13;0;0;0;1;1;0;0;0;5;5;0;9;5;4;1;0
Morgan Schneiderlin;32;Midfielder;Everton;833;473;360;France;14;9;5;0;0;0;1;1;0;0;0;7;5;2;9;5;4;2;0
Moussa Dembele;35;Midfielder;Tottenham Hotspur;516;161;355;Belgium;10;3;7;0;0;0;0;0;0;0;0;3;0;3;5;3;2;1;0
Moussa Sissoko;33;Midfielder;Tottenham Hotspur;2336;1187;1149;France;29;15;14;0;0;0;3;2;1;0;0;11;6;5;26;10;16;2;0
N'Golo Kanté;31;Midfielder;Chelsea;3096;1579;1517;France;36;19;17;4;2;2;4;3;1;0;0;15;10;5;37;12;25;3;0
Naby Keïta;27;Midfielder;Liverpool;1392;729;663;Guinea;25;14;11;2;1;1;1;1;0;0;0;15;10;5;7;4;3;0;0
Nacho Monreal;36;Defender;Arsenal;1861;781;1080;Spain;22;10;12;1;1;0;3;0;3;0;0;6;5;1;21;3;18;5;0
Nampalys Mendy;30;Midfielder;Leicester City;2088;1006;1082;France;31;16;15;0;0;0;0;0;0;0;0;9;5;4;26;11;15;5;0
Nathan Aké;27;Defender;AFC Bournemouth;3412;1710;1702;Netherlands;38;19;19;4;3;1;0;0;0;0;0;10;6;4;66;23;43;3;0
Nathan Holland;24;Midfielder;West Ham United;0;0;0;England;0;0;0;0;0;0;0;0;0;0;0;0;0;0;0;0;0;0;0
Nathan Redmond;28;Midfielder;Southampton;3276;1633;1643;England;38;19;19;6;4;2;4;2;2;0;0;7;3;4;53;22;31;3;0
Nathaniel Chalobah;27;Midfielder;Watford;266;67;199;England;9;3;6;0;0;0;0;0;0;0;0;1;1;0;5;2;3;2;0
Nathaniel Clyne;31;Defender;AFC Bournemouth;1254;684;570;England;18;10;8;0;0;0;1;0;1;0;0;6;4;2;24;6;18;2;0
Nathaniel Mendez-Laing;30;Midfielder;Cardiff City;984;442;542;England;20;9;11;4;0;4;1;1;0;1;0;6;3;3;15;8;7;0;0
Neeskens Kebano;30;Midfielder;Fulham;103;74;29;Congo DR;7;5;2;0;0;0;0;0;0;0;0;0;0;0;1;0;1;0;0
Neil Leonard Dula Etheridge;32;Goalkeeper;Cardiff City;3420;1710;1710;Philippines;38;19;19;0;0;0;0;0;0;0;0;10;5;5;61;34;27;2;0
Nemanja Matić;34;Midfielder;Manchester United;2441;1051;1390;Serbia;28;12;16;1;1;0;0;0;0;0;0;6;1;5;35;14;21;8;1
Nicolas Otamendi;34;Defender;Manchester City;1233;682;551;Argentina;18;9;9;0;0;0;0;0;0;0;0;10;3;7;7;6;1;1;0
Nikola Tavares;23;Defender;Crystal Palace;0;0;0;England;0;0;0;0;0;0;0;0;0;0;0;0;0;0;0;0;0;0;0
Nnamdi Ofoborh;22;Midfielder;AFC Bournemouth;0;0;0;England;0;0;0;0;0;0;0;0;0;0;0;0;0;0;0;0;0;0;0
Oleksandr Zinchenko;25;Midfielder;Manchester City;1153;613;540;Ukraine;14;8;6;0;0;0;3;2;1;0;0;10;6;4;4;2;2;1;0
Oliver Skipp;22;Midfielder;Tottenham Hotspur;216;191;25;England;8;6;2;0;0;0;0;0;0;0;0;4;3;1;0;0;0;0;0
Olivier Giroud;36;Forward;Chelsea;832;446;386;France;27;14;13;2;1;1;4;3;1;0;0;12;7;5;4;1;3;1;0
Oriol Romeu;31;Midfielder;Southampton;2140;1110;1030;Spain;31;16;15;1;1;0;0;0;0;0;0;6;3;3;32;16;16;11;0
Oumar Niasse;32;Forward;Cardiff City;998;435;563;Senegal;18;8;10;0;0;0;0;0;0;0;0;3;2;1;12;5;7;0;0
Pablo Zabaleta;37;Defender;West Ham United;2092;1216;876;Argentina;26;14;12;0;0;0;1;1;0;0;0;4;2;2;32;22;10;4;0
Pape N'Diaye Souaré;32;Defender;Crystal Palace;0;0;0;Senegal;1;0;1;0;0;0;0;0;0;0;0;1;0;1;0;0;0;0;0
Pascal Groß;31;Midfielder;Brighton & Hove Albion;1878;993;885;Germany;25;13;12;3;2;1;3;1;2;1;1;3;2;1;31;16;15;1;0
Patrick van Aanholt;32;Defender;Crystal Palace;3198;1703;1495;Netherlands;36;19;17;3;2;1;2;0;2;0;0;12;7;5;41;19;22;3;0
Paul Dummett;31;Defender;Newcastle United;1986;979;1007;Wales;26;13;13;0;0;0;0;0;0;0;0;9;3;6;27;15;12;1;0
Paul Pogba;29;Midfielder;Manchester United;3011;1517;1494;France;35;18;17;13;10;3;9;4;5;7;3;7;2;5;41;20;21;6;0
Paulo Gazzaniga;30;Goalkeeper;Tottenham Hotspur;270;0;270;Argentina;3;0;3;0;0;0;0;0;0;0;0;1;0;1;1;0;1;0;0
Pedro Obiang;30;Midfielder;West Ham United;1121;609;512;Equatorial Guinea;24;13;11;0;0;0;1;0;1;0;0;7;4;3;17;9;8;0;0
Pedro Rodriguez;35;Midfielder;Chelsea;1780;958;822;Spain;31;15;16;8;6;2;2;2;0;0;0;11;7;4;18;7;11;2;0
Peter Crouch;41;Forward;Burnley;86;56;30;England;6;4;2;0;0;0;0;0;0;0;0;0;0;0;0;0;0;1;0
Petr Čech;40;Goalkeeper;Arsenal;585;315;270;Czech Republic;7;4;3;0;0;0;0;0;0;0;0;2;2;0;8;3;5;0;0
Phil Bardsley;37;Defender;Burnley;1672;900;772;Scotland;19;10;9;0;0;0;0;0;0;0;0;4;3;1;22;11;11;9;0
Phil Foden;22;Midfielder;Manchester City;327;279;48;England;13;10;3;1;1;0;0;0;0;0;0;8;6;2;0;0;0;0;0
Phil Jagielka;40;Defender;Everton;329;95;234;England;7;3;4;1;1;0;0;0;0;0;0;5;3;2;2;0;2;1;1
Phil Jones;30;Defender;Manchester United;1263;652;611;England;18;9;9;0;0;0;1;0;1;0;0;4;0;4;16;9;7;1;0
Philip Billing;26;Midfielder;Huddersfield Town;2192;1106;1086;Denmark;27;13;14;2;1;1;0;0;0;0;0;5;3;2;41;17;24;7;0
Philippe Sandler;25;Defender;Manchester City;0;0;0;Netherlands;0;0;0;0;0;0;0;0;0;0;0;0;0;0;0;0;0;0;0
Pierre-Emerick Aubameyang;33;Forward;Arsenal;2731;1418;1313;Gabon;36;19;17;22;13;9;5;4;1;4;1;8;7;1;40;14;26;0;0
Pierre-Emile Højbjerg;27;Midfielder;Southampton;2764;1416;1348;Denmark;31;16;15;4;2;2;3;2;1;0;0;4;1;3;52;23;29;10;2
Rachid Ghezzal;30;Forward;Leicester City;738;455;283;Algeria;19;12;7;1;1;0;0;0;0;0;0;3;2;1;12;6;6;3;0
Rafael Euclides Soares Camacho;22;Midfielder;Liverpool;0;0;0;Portugal;1;1;0;0;0;0;0;0;0;0;0;0;0;0;0;0;0;0;0
Raheem Sterling;27;Forward;Manchester City;2777;1256;1521;England;34;16;18;17;12;5;10;6;4;0;0;18;7;11;19;9;10;3;0
Rajiv van La Parra;31;Midfielder;Huddersfield Town;407;168;239;Netherlands;5;2;3;0;0;0;0;0;0;0;0;1;1;0;6;1;5;0;0
Ramadan Sobhi;25;Forward;Huddersfield Town;75;30;45;Egypt;4;1;3;0;0;0;0;0;0;0;0;0;0;0;1;0;1;0;0
Raúl Jiménez;31;Forward;Wolverhampton Wanderers;3124;1648;1476;Mexico;38;19;19;13;8;5;7;4;3;2;0;9;7;2;39;20;19;4;0
Rhys Healey;27;Forward;Cardiff City;49;17;32;England;3;1;2;0;0;0;0;0;0;0;0;1;1;0;1;0;1;0;0
Ricardo Pereira;29;Defender;Leicester City;3125;1526;1599;Portugal;35;17;18;2;2;0;6;3;3;0;0;10;6;4;40;16;24;7;0
Richarlison;25;Forward;Everton;2679;1283;1396;Brazil;35;17;18;13;7;6;1;1;0;0;0;14;9;5;32;15;17;6;1
Riyad Mahrez;31;Midfielder;Manchester City;1339;647;692;Algeria;27;14;13;7;1;6;4;2;2;0;1;13;6;7;9;4;5;0;0
Rob Holding;27;Defender;Arsenal;807;501;306;England;10;6;4;0;0;0;0;0;0;0;0;2;2;0;10;5;5;1;0
Robbie Brady;30;Midfielder;Burnley;715;390;325;Republic of Ireland;16;9;7;0;0;0;1;0;1;0;0;2;1;1;12;8;4;4;1
Robert Kenedy Nunes do Nascimento;26;Midfielder;Newcastle United;1344;611;733;Brazil;25;13;12;1;0;1;1;1;0;0;1;8;3;5;17;9;8;1;0
Robert Snodgrass;35;Midfielder;West Ham United;2222;1108;1114;Scotland;33;16;17;2;1;1;5;4;1;0;0;6;3;3;31;16;15;10;0
Roberto Firmino;31;Forward;Liverpool;2620;1347;1273;Brazil;34;16;18;12;7;5;6;3;3;1;0;18;9;9;13;7;6;0;0
Roberto Pereyra;31;Forward;Watford;2825;1467;1358;Argentina;33;17;16;6;5;1;1;0;1;0;0;5;3;2;52;27;25;3;0
Romain Saïss;32;Midfielder;Wolverhampton Wanderers;1144;544;600;Morocco;19;8;11;2;1;1;0;0;0;0;0;4;3;1;16;6;10;7;0
Romelu Lukaku;29;Forward;Manchester United;2130;982;1148;Belgium;32;16;16;12;4;8;0;0;0;0;0;7;2;5;36;14;22;4;0
Rondon;33;Forward;Newcastle United;2609;1343;1266;Venezuela;32;16;16;11;6;5;7;5;2;0;0;10;5;5;29;14;15;1;0
Ross Barkley;28;Midfielder;Chelsea;1241;432;809;England;27;11;16;3;1;2;5;2;3;0;0;11;5;6;13;5;8;1;0
Ruben Loftus-Cheek;26;Midfielder;Chelsea;983;507;476;England;24;12;12;6;3;3;2;2;0;0;0;12;9;3;8;2;6;0;0
Rúben Neves;25;Midfielder;Wolverhampton Wanderers;3009;1451;1558;Portugal;35;17;18;4;3;1;3;2;1;2;0;8;6;2;40;19;21;8;0
Ruben Vinagre;23;Defender;Wolverhampton Wanderers;703;514;189;Portugal;17;12;5;0;0;0;0;0;0;0;0;5;4;1;9;6;3;1;0
Rui Patrício;34;Goalkeeper;Wolverhampton Wanderers;3330;1620;1710;Portugal;37;18;19;0;0;0;0;0;0;0;0;8;6;2;43;20;23;0;0
Ryan Bennett;32;Defender;Wolverhampton Wanderers;3060;1710;1350;England;34;19;15;1;1;0;0;0;0;0;0;9;7;2;36;20;16;12;0
Ryan Bertrand;33;Defender;Southampton;2160;1170;990;England;24;13;11;1;1;0;0;0;0;0;0;6;3;3;36;15;21;8;0
Ryan Fraser;28;Midfielder;AFC Bournemouth;3173;1605;1568;Scotland;38;19;19;7;5;2;14;5;9;0;0;10;6;4;61;23;38;2;0
Ryan Fredericks;30;Midfielder;West Ham United;1085;404;681;England;15;5;10;1;1;0;0;0;0;0;0;3;2;1;13;1;12;5;0
Ryan Giles;22;Midfielder;Wolverhampton Wanderers;0;0;0;England;0;0;0;0;0;0;0;0;0;0;0;0;0;0;0;0;0;0;0
Ryan Guno Babel;35;Forward;Fulham;1260;668;592;Netherlands;16;9;7;5;3;2;3;3;0;0;0;3;2;1;24;12;12;3;0
Ryan Schofield;22;Goalkeeper;Huddersfield Town;0;0;0;England;0;0;0;0;0;0;0;0;0;0;0;0;0;0;0;0;0;0;0
Ryan Sessegnon;22;Defender;Fulham;2298;1095;1203;England;35;18;17;2;1;1;6;3;3;0;0;4;3;1;58;22;36;0;0
Sadio Mané;30;Forward;Liverpool;3086;1643;1443;Senegal;36;19;17;22;18;4;1;0;1;0;0;20;12;8;18;8;10;2;0
Sam Gallagher;27;Forward;Southampton;30;7;23;England;4;1;3;0;0;0;0;0;0;0;0;1;0;1;0;0;0;0;0
Sam Surridge;24;Forward;AFC Bournemouth;11;0;11;England;2;0;2;0;0;0;0;0;0;0;0;0;0;0;0;0;0;0;0
Sam Vokes;33;Forward;Burnley;913;455;458;Wales;20;10;10;3;2;1;0;0;0;0;0;4;2;2;18;9;9;0;0
Sam Woods;24;Defender;Crystal Palace;0;0;0;England;0;0;0;0;0;0;0;0;0;0;0;0;0;0;0;0;0;0;0
Samir Nasri;35;Midfielder;West Ham United;246;102;144;France;5;2;3;0;0;0;2;2;0;0;0;1;1;0;2;1;1;0;0
Sandro Ramirez;27;Forward;Everton;0;0;0;Spain;0;0;0;0;0;0;0;0;0;0;0;0;0;0;0;0;0;0;0
Scott Dann;35;Defender;Crystal Palace;660;360;300;England;10;4;6;0;0;0;1;0;1;0;0;3;2;1;7;4;3;1;0
Scott McTominay;25;Midfielder;Manchester United;861;345;516;England;16;7;9;2;0;2;0;0;0;0;0;3;1;2;17;6;11;1;0
Sead Kolašinac;29;Defender;Arsenal;1891;1127;764;Bosnia and Herzegovina;24;14;10;0;0;0;5;3;2;0;0;5;5;0;26;10;16;5;0
Séamus Coleman;34;Defender;Everton;2560;1333;1227;Republic of Ireland;29;15;14;2;2;0;2;0;2;0;0;13;8;5;29;15;14;1;0
Sean Longstaff;25;Midfielder;Newcastle United;688;355;333;England;9;4;5;1;1;0;0;0;0;0;0;3;3;0;8;1;7;2;0
Sean Morrison;31;Defender;Cardiff City;3040;1600;1440;England;34;18;16;1;0;1;3;2;1;0;0;9;4;5;57;34;23;6;0
Sebastian Prödl;35;Defender;Watford;13;0;13;Austria;1;0;1;0;0;0;0;0;0;0;0;1;0;1;0;0;0;0;0
Serge Aurier;29;Defender;Tottenham Hotspur;564;136;428;Ivory Coast;8;2;6;0;0;0;2;0;2;0;0;3;0;3;9;2;7;1;0
Sergio Aguero;34;Forward;Manchester City;2480;1125;1355;Argentina;33;16;17;21;15;6;8;5;3;2;0;19;8;11;15;8;7;3;0
Sergio Rico;29;Goalkeeper;Fulham;2610;1350;1260;Spain;29;15;14;0;0;0;0;0;0;0;0;5;3;2;53;24;29;1;0
Sergio Romero;35;Goalkeeper;Manchester United;0;0;0;Argentina;0;0;0;0;0;0;0;0;0;0;0;0;0;0;0;0;0;0;0
Shane Duffy;30;Defender;Brighton & Hove Albion;3088;1558;1530;Republic of Ireland;35;18;17;5;2;3;1;1;0;0;0;7;5;2;51;23;28;5;1
Shane Long;35;Forward;Southampton;1269;629;640;Republic of Ireland;26;15;11;5;3;2;1;1;0;0;0;5;2;3;20;7;13;3;0
Shinji Okazaki;36;Forward;Leicester City;269;126;143;Japan;21;13;8;0;0;0;1;0;1;0;0;2;2;0;1;0;1;0;0
Shkodran Mustafi;30;Defender;Arsenal;2617;1263;1354;Germany;31;15;16;2;0;2;0;0;0;0;0;6;5;1;36;12;24;9;0
Simon Francis;37;Defender;AFC Bournemouth;1226;675;551;England;17;9;8;0;0;0;2;1;1;0;0;5;3;2;23;11;12;1;0
Simon Mignolet;34;Goalkeeper;Liverpool;0;0;0;Belgium;0;0;0;0;0;0;0;0;0;0;0;0;0;0;0;0;0;0;0
Sokratis Papastathopoulos;34;Defender;Arsenal;2199;1119;1080;Greece;25;13;12;1;0;1;2;2;0;0;0;6;6;0;31;9;22;12;0
Solly March;28;Midfielder;Brighton & Hove Albion;2473;1153;1320;England;35;16;19;1;1;0;5;1;4;0;0;6;4;2;39;13;26;1;0
Souleymane Bamba;37;Defender;Cardiff City;2475;1260;1215;Ivory Coast;28;14;14;4;2;2;1;1;0;0;0;7;4;3;46;23;23;7;0
Stefan Marius Johansen;31;Midfielder;Fulham;412;130;282;Norway;12;5;7;0;0;0;0;0;0;0;0;0;0;0;11;1;10;4;0
Stefano Okaka;33;Forward;Watford;22;9;13;Italy;2;1;1;0;0;0;0;0;0;0;0;0;0;0;1;1;0;1;0
Stephan Lichtsteiner;38;Defender;Arsenal;940;408;532;Switzerland;14;7;7;0;0;0;0;0;0;0;0;2;2;0;18;4;14;3;0
Stephen Ward;37;Defender;Burnley;230;74;156;Republic of Ireland;3;1;2;0;0;0;0;0;0;0;0;1;0;1;6;3;3;1;0
Steve Cook;31;Defender;AFC Bournemouth;2787;1350;1437;England;31;15;16;1;0;1;1;0;1;0;0;9;6;3;53;17;36;3;0
Steve Mounié;28;Forward;Huddersfield Town;1777;1009;768;Benin;31;16;15;2;2;0;3;1;2;0;0;5;3;2;34;15;19;2;1
Steven Davis;37;Midfielder;Southampton;96;6;90;Northern Ireland;3;2;1;0;0;0;1;0;1;0;0;0;0;0;3;0;3;0;0
Steven Defour;34;Midfielder;Burnley;452;172;280;Belgium;6;2;4;0;0;0;0;0;0;0;0;1;0;1;12;5;7;0;0
Stuart Armstrong;30;Midfielder;Southampton;1432;469;963;Scotland;29;11;18;3;1;2;2;1;1;0;0;4;1;3;23;8;15;2;0
Sullay Kaikai;27;Midfielder;Crystal Palace;0;0;0;England;0;0;0;0;0;0;0;0;0;0;0;0;0;0;0;0;0;0;0
Tahith Chong;22;Forward;Manchester United;36;0;36;Netherlands;2;1;1;0;0;0;0;0;0;0;0;0;0;0;1;0;1;0;0
Terence Kongolo;28;Defender;Huddersfield Town;2722;1405;1317;Netherlands;32;17;15;1;0;1;1;0;1;0;0;4;3;1;62;27;35;4;0
Theo Walcott;33;Forward;Everton;2122;1114;1008;England;37;19;18;5;3;2;2;2;0;0;0;13;9;4;33;18;15;1;0
Tim Ream;35;Defender;Fulham;2051;943;1108;USA;26;13;13;0;0;0;0;0;0;0;0;5;3;2;47;18;29;1;0
Timothy Eyoma;22;Defender;Tottenham Hotspur;0;0;0;England;0;0;0;0;0;0;0;0;0;0;0;0;0;0;0;0;0;0;0
Timothy Fosu-Mensah;24;Defender;Fulham;795;499;296;Netherlands;12;6;6;0;0;0;0;0;0;0;0;1;1;0;18;9;9;3;0
Toby Alderweireld;33;Defender;Tottenham Hotspur;2924;1549;1375;Belgium;34;18;16;0;0;0;0;0;0;0;0;12;6;6;28;15;13;3;0
Tom Cairney;31;Midfielder;Fulham;2198;1107;1091;Scotland;31;16;15;1;1;0;1;1;0;0;0;4;3;1;49;21;28;0;0
Tom Cleverley;33;Midfielder;Watford;470;102;368;England;13;4;9;1;0;1;0;0;0;0;0;4;2;2;7;0;7;2;0
Tom Davies;24;Midfielder;Everton;975;520;455;England;16;8;8;0;0;0;0;0;0;0;0;5;3;2;18;12;6;3;0
Tom Heaton;36;Goalkeeper;Burnley;1710;900;810;England;19;10;9;0;0;0;0;0;0;0;0;4;3;1;23;10;13;3;0
Tom Smith;30;Defender;Huddersfield Town;1141;431;710;England;15;6;9;0;0;0;0;0;0;0;0;1;0;1;34;12;22;3;1
Trent Alexander-Arnold;24;Defender;Liverpool;2467;1266;1201;England;29;15;14;1;0;1;12;8;4;0;0;16;11;5;14;4;10;3;0
Troy Deeney;34;Forward;Watford;2548;1298;1250;England;32;16;16;9;3;6;5;1;4;1;0;5;3;2;43;23;20;5;1
Tyias Browning;28;Defender;Everton;0;0;0;England;0;0;0;0;0;0;0;0;0;0;0;0;0;0;0;0;0;0;0
Tyreke Johnson;24;Defender;Southampton;0;0;0;England;1;1;0;0;0;0;0;0;0;0;0;0;0;0;0;0;0;0;0
Tyrone Mings;29;Defender;AFC Bournemouth;141;7;134;England;5;2;3;0;0;0;0;0;0;0;0;0;0;0;4;0;4;0;0
Vicente Guaita;35;Goalkeeper;Crystal Palace;1755;1035;720;Spain;20;12;8;0;0;0;0;0;0;0;0;7;5;2;21;12;9;2;0
Vicente Iborra De La Fuente;34;Midfielder;Leicester City;226;152;74;Spain;8;3;5;0;0;0;0;0;0;0;0;3;1;2;4;2;2;0;0
Víctor Camarasa;28;Midfielder;Cardiff City;2579;1267;1312;Spain;32;16;16;5;4;1;4;1;3;1;0;8;4;4;48;25;23;6;0
Victor Lindelöf;28;Defender;Manchester United;2602;1112;1490;Sweden;30;13;17;1;1;0;1;0;1;0;0;6;2;4;38;13;25;1;0
Victor Moses;31;Midfielder;Chelsea;26;17;9;Nigeria;2;1;1;0;0;0;0;0;0;0;0;1;0;1;1;1;0;0;0
Victor Wanyama;31;Midfielder;Tottenham Hotspur;509;302;207;Kenya;13;9;4;1;1;0;0;0;0;0;0;6;4;2;3;3;0;2;0
Viktor Gyökeres;24;Forward;Brighton & Hove Albion;0;0;0;Sweden;0;0;0;0;0;0;0;0;0;0;0;0;0;0;0;0;0;0;0
Vincent Janssen;28;Forward;Tottenham Hotspur;36;36;0;Netherlands;3;3;0;0;0;0;0;0;0;0;0;1;1;0;0;0;0;0;0
Vincent Kompany;36;Defender;Manchester City;1223;561;662;Belgium;17;8;9;1;1;0;0;0;0;0;0;7;3;4;7;3;4;6;0
Virgil van Dijk;31;Defender;Liverpool;3385;1675;1710;Netherlands;38;19;19;4;2;2;2;1;1;0;0;21;12;9;19;8;11;1;0
Wayne Hennessey;35;Goalkeeper;Crystal Palace;1575;675;900;Wales;18;8;10;0;0;0;0;0;0;0;0;5;2;3;23;8;15;0;0
Wes Morgan;38;Defender;Leicester City;1926;783;1143;Jamaica;22;9;13;3;1;2;0;0;0;0;0;6;3;3;24;9;15;5;2
Wesley Hoedt;28;Defender;Southampton;1170;540;630;Netherlands;13;6;7;0;0;0;0;0;0;0;0;4;2;2;20;5;15;2;0
Wilfred Ndidi;25;Midfielder;Leicester City;3299;1624;1675;Nigeria;38;19;19;2;2;0;0;0;0;0;0;10;6;4;42;18;24;8;0
Wilfried Zaha;29;Midfielder;Crystal Palace;3041;1347;1694;Ivory Coast;34;15;19;10;1;9;5;3;2;0;0;10;5;5;45;18;27;10;1
Will Hughes;27;Midfielder;Watford;2436;1251;1185;England;32;16;16;2;1;1;4;2;2;0;0;5;3;2;39;19;20;5;0
Will Norris;29;Goalkeeper;Wolverhampton Wanderers;0;0;0;England;1;1;0;0;0;0;0;0;0;0;0;1;1;0;0;0;0;0;0
Willian;34;Forward;Chelsea;2108;833;1275;Brazil;32;15;17;3;2;1;6;3;3;0;0;13;7;6;23;6;17;2;0
Willy Boly;31;Defender;Wolverhampton Wanderers;3169;1530;1639;France;36;17;19;4;2;2;0;0;0;0;0;8;6;2;38;17;21;3;1
Willy Caballero;41;Goalkeeper;Chelsea;180;90;90;Argentina;2;1;1;0;0;0;0;0;0;0;0;2;1;1;0;0;0;0;0
Xherdan Shaqiri;31;Midfielder;Liverpool;1058;538;520;Switzerland;24;12;12;6;5;1;3;0;3;0;0;12;7;5;5;3;2;2;0
Yan Valery;23;Defender;Southampton;1715;1070;645;France;23;13;10;2;1;1;1;1;0;0;0;3;1;2;26;17;9;5;1
Yerry Mina;28;Defender;Everton;890;360;530;Colombia;13;6;7;1;0;1;0;0;0;0;0;4;3;1;12;3;9;3;0
Yoshinori Muto;30;Forward;Newcastle United;516;180;336;Japan;17;8;9;1;0;1;0;0;0;0;0;5;1;4;10;3;7;1;0
Youri Tielemans;25;Midfielder;Leicester City;1092;575;517;Belgium;13;7;6;3;2;1;4;2;2;0;0;3;3;0;13;5;8;2;0
Yves Bissouma;26;Midfielder;Brighton & Hove Albion;1769;747;1022;Mali;28;13;15;0;0;0;0;0;0;0;0;5;4;1;30;14;16;5;0
Zechariah Medley;22;Defender;Arsenal;0;0;0;England;0;0;0;0;0;0;0;0;0;0;0;0;0;0;0;0;0;0;0
Zeze  Steven Sessegnon;22;Defender;Fulham;0;0;0;England;0;0;0;0;0;0;0;0;0;0;0;0;0;0;0;0;0;0;0
Łukasz Fabiański;37;Goalkeeper;West Ham United;3420;1710;1710;Poland;38;19;19;0;0;0;0;0;0;0;0;7;4;3;48;23;25;0;0